TABLE	|	QUERY
tutorials_tbl	|	create table tutorials_tbl(tutorial_id INT NOT_NULL ,tutorial_title VARCHAR NOT_NULL,tutorial_author VARCHAR NOT_NULL,submission_date VARCHAR,PRIMARY_KEY (tutorial_id),CONSTRAINT fk_customer FOREIGN_KEY (Customer_Id) REFERENCES table_c(column1))
tutorials_tbl1	|	create table tutorials_tbl1(tutorial_id INT NOT_NULL ,tutorial_title VARCHAR NOT_NULL,tutorial_author VARCHAR NOT_NULL,submission_date VARCHAR,PRIMARY_KEY (tutorial_id),CONSTRAINT fk_customer FOREIGN_KEY (Customer_Id) REFERENCES table_c(column1))
tutorials_tb2	|	create table tutorials_tb2(tutorial_id INT NOT_NULL ,tutorial_title VARCHAR NOT_NULL,tutorial_author VARCHAR NOT_NULL,submission_date VARCHAR,PRIMARY_KEY (tutorial_id),CONSTRAINT fk_customer FOREIGN_KEY (Customer_Id) REFERENCES table_c(column1))
tutorials_tbl3	|	create table tutorials_tbl3(tutorial_id INT NOT_NULL ,tutorial_title VARCHAR NOT_NULL,tutorial_author VARCHAR NOT_NULL,submission_date VARCHAR,PRIMARY_KEY (tutorial_id),CONSTRAINT fk_customer FOREIGN_KEY (Customer_Id) REFERENCES table_c(column1))
tutorials_tbl	|	create table tutorials_tbl(tutorial_id INT NOT_NULL ,tutorial_title VARCHAR NOT_NULL,tutorial_author VARCHAR NOT_NULL,submission_date VARCHAR,PRIMARY_KEY (tutorial_id),CONSTRAINT fk_customer FOREIGN_KEY (Customer_Id) REFERENCES table_c(column1))
user_data1	|	create table user_data1 (user_id INT NOT_NULL,user_name VARCHAR NOT_NULL,user_surname VARCHAR NOT_NULL,user_email VARCHAR NOT_NULL,user_contact INT NOT_NULL)
user_data	|	create table user_data (user_id INT NOT_NULL,user_name VARCHAR NOT_NULL,user_surname VARCHAR NOT_NULL,user_email VARCHAR NOT_NULL,user_contact INT NOT_NULL)
user_data2	|	create table user_data2 (user_id INT NOT_NULL,user_name VARCHAR NOT_NULL,user_surname VARCHAR NOT_NULL,user_email VARCHAR NOT_NULL,user_contact INT NOT_NULL)
tutorials_tbl   |	create table tutorials_tbl(tutorial_id INT NOT_NULL ,tutorial_title VARCHAR NOT_NULL,tutorial_author VARCHAR NOT_NULL,submission_date VARCHAR,PRIMARY_KEY (tutorial_id),CONSTRAINT fk_customer FOREIGN_KEY (Customer_Id) REFERENCES table_c(column1))
table_a |	create table table_a(id INT NOT_NULL ,Name VARCHAR NOT_NULL,Company VARCHAR NOT_NULL,code VARCHAR,PRIMARY_KEY (id),CONSTRAINT fk_customer FOREIGN_KEY (code) REFERENCES table_n(code))
table_b |	create table table_b(id INT NOT_NULL ,Name VARCHAR NOT_NULL,Company VARCHAR NOT_NULL,code VARCHAR,PRIMARY_KEY (id),CONSTRAINT fk_customer FOREIGN_KEY (code) REFERENCES table_n(code))
table_c |	create table table_c(id INT NOT_NULL ,Name VARCHAR NOT_NULL,Company VARCHAR NOT_NULL,code VARCHAR,PRIMARY_KEY (id),CONSTRAINT fk_customer FOREIGN_KEY (code) REFERENCES table_n(code))
table_d |	create table table_d(id INT NOT_NULL ,Name VARCHAR NOT_NULL,Company VARCHAR NOT_NULL,code VARCHAR,PRIMARY_KEY (id),CONSTRAINT fk_customer FOREIGN_KEY (code) REFERENCES table_n(code))
table_e |	create table table_e(id INT NOT_NULL ,Name VARCHAR NOT_NULL,Company VARCHAR NOT_NULL,code VARCHAR,PRIMARY_KEY (id),CONSTRAINT fk_customer FOREIGN_KEY (code) REFERENCES table_n(code))
table_f |	create table table_f(id INT NOT_NULL ,Name VARCHAR NOT_NULL,Company VARCHAR NOT_NULL,code VARCHAR,PRIMARY_KEY (id),CONSTRAINT fk_customer FOREIGN_KEY (code) REFERENCES table_n(code))
table_g |	create table table_g(id INT NOT_NULL ,Name VARCHAR NOT_NULL,Company VARCHAR NOT_NULL,code VARCHAR,PRIMARY_KEY (id),CONSTRAINT fk_customer FOREIGN_KEY (code) REFERENCES table_n(code))
table_h |	create table table_h(id INT NOT_NULL ,Name VARCHAR NOT_NULL,Company VARCHAR NOT_NULL,code VARCHAR,PRIMARY_KEY (id),CONSTRAINT fk_customer FOREIGN_KEY (code) REFERENCES table_n(code))
table_i |	create table table_i(id INT NOT_NULL ,Name VARCHAR NOT_NULL,Company VARCHAR NOT_NULL,code VARCHAR,PRIMARY_KEY (id),CONSTRAINT fk_customer FOREIGN_KEY (code) REFERENCES table_n(code))
table_j |	create table table_j(id INT NOT_NULL ,Name VARCHAR NOT_NULL,Company VARCHAR NOT_NULL,code VARCHAR,PRIMARY_KEY (id),CONSTRAINT fk_customer FOREIGN_KEY (code) REFERENCES table_n(code))
table_k |	create table table_k(id INT NOT_NULL ,Name VARCHAR NOT_NULL,Company VARCHAR NOT_NULL,code VARCHAR,PRIMARY_KEY (id),CONSTRAINT fk_customer FOREIGN_KEY (code) REFERENCES table_n(code))
table_l |	create table table_l(id INT NOT_NULL ,Name VARCHAR NOT_NULL,Company VARCHAR NOT_NULL,code VARCHAR,PRIMARY_KEY (id),CONSTRAINT fk_customer FOREIGN_KEY (code) REFERENCES table_n(code))
table_m |	create table table_m(id INT NOT_NULL ,Name VARCHAR NOT_NULL,Company VARCHAR NOT_NULL,code VARCHAR,PRIMARY_KEY (id),CONSTRAINT fk_customer FOREIGN_KEY (code) REFERENCES table_n(code))
table_n |	create table table_n(code varchar NOT_NULL,name varchar NOT_NULL,PRIMARY_KEY (code))
table_o	|	create table table_o(id INT NOT_NULL ,Name VARCHAR NOT_NULL,Company VARCHAR NOT_NULL,code VARCHAR,PRIMARY_KEY (id),CONSTRAINT fk_customer FOREIGN_KEY (code) REFERENCES table_n(code))
table_o	|	create table table_o(id INT NOT_NULL ,Name VARCHAR NOT_NULL,Company VARCHAR NOT_NULL,code VARCHAR,PRIMARY_KEY (id),CONSTRAINT fk_customer FOREIGN_KEY (code) REFERENCES table_n(code))
table_o	|	create table table_o(id INT NOT_NULL ,Name VARCHAR NOT_NULL,Company VARCHAR NOT_NULL,code VARCHAR,PRIMARY_KEY (id),CONSTRAINT fk_customer FOREIGN_KEY (code) REFERENCES table_n(code))
table_o	|	create table table_o(id INT NOT_NULL ,Name VARCHAR NOT_NULL,Company VARCHAR NOT_NULL,code VARCHAR,PRIMARY_KEY (id),CONSTRAINT fk_customer FOREIGN_KEY (code) REFERENCES table_n(code))
table_p	|	create table table_p(id INT NOT_NULL ,Name VARCHAR NOT_NULL,Company VARCHAR NOT_NULL,code VARCHAR,PRIMARY_KEY (id))
table_q	|	create table table_q(id INT NOT_NULL ,Name VARCHAR NOT_NULL,Company VARCHAR NOT_NULL,code VARCHAR)
student	|	CREATE TABLE student(id int not_null ,name varchar not_null,address varchar not_null, contact int,PRIMARY_KEY (id))
student	|	CREATE TABLE student(id int not_null ,name varchar not_null,address varchar not_null, contact int,PRIMARY_KEY (id))
student	|	CREATE TABLE student(id int not_null ,name varchar not_null,address varchar not_null, contact int,PRIMARY_KEY (id))
abc	|	create table abc(id int)
